#########################
#.......#....#..........#
#..###..#....#.....###..#
#.......#....#..........#
#..###....##....#####...#
#..#......##....#...#...#
#..#.###................#
#.....##........#####...#
#.....#          #####..#
#......           ......#
#........# P   #........#
#........#######.######.#
#..........    ..#....#.#
#..####....    ....##.#.#
#..####....    .........#
#..#..#....#######..#...#
#..#..#....#.....#..#...#
#..........#.....#..#...#
#.......####.....#..#...#
#.#####.................#
#.#.....................#
#.#........     #######.#
#.#........     #######.#
#..........     #######.#
#########################
