#########################
#.............#.........#
#.###E.######.#.#####E..#
#.#...........#.........#
#.#.###.####..###..####.#
#.......................#
#......         ........#
#........      ....##.###
#.......#  P   #........#
#.......########........#
#.#####.       .........#
#.......       .........#
#.######.......#######..#
#.#.##.....##....##..#..#
#.#.##.....##....##..#..#
#.#.....#......#.....#..#
#.#.....########.....#..#
#....##.................#
#.......................#
#...E.#.........#.#.E.#.#
#.....#.................#
####..#.........#.....#.#
#.....#.................#
#.#####.........#######.#
#########################