#########################
#.......................#
#.......................#
#.......................#
#.......................#
#.......................#
#.......................#
#.......................#
#..........P............#
#.......................#
#.......................#
#.......................#
#.......................#
#.......................#
#.......................#
#.......................#
#.......................#
#.......................#
#...EEEE................#
#.......................#
#.......................#
#.#####.................#
#.#####.................#
#.#####.........#######.#
#########################